-44
47
-21
21
00000000000000000000000000000000000000000000000000000000000000000000000000000000000000000000
00000000000000000000000000000000000000000000000000000000000000000000000000000000000000000000
00000000000000000000000000000000000000000000000000000000000000000000000000000000000000000000
00000000000000000000000000000000000000000000000000000000000000000000000000000000000000000000
00000000000000000000000000000000000000000000000000000000000000000000000000000000000000000000
00000000000000011111111111111111111111111111111111111111111111111111111111100000000000000000
00000000000000010111111100000000000000000000000000000000000000000011111110100000000000000000
00000000000000010111111100000000000000000000000000000000000000000011111110100000000000000000
00000000000000011111111100000000000111100000000001111000000000000111111110100000000000000000
00000000000000011111111100000000000000000000000000000000000000000111111110100000000000000000
00000000000000011111111100000000000000000000000000000000000000000111111110100000000000000000
00000000000000010111111100000000000000000000000000000000000000000011111110100000000000000000
00000000000000010011111100000000000000000000000000000000000000000001111110100000000000000000
00000000000000010111111110000000000111100000000001111000000000000011111111100000000000000000
00000000000000010111111110000000000000000000000000000000000000000011111111100000000000000000
00000000000000010111111100000000000000000000000000000000000000000011111110100000000000000000
00000000000000010111111100000000000000000000000000000000000000000011111110100000000000000000
00000000000000010000000000000000000000000000000000000000000000000000000000100000000000000000
00000000000000010000000111100000000111100000000001111000000000111100000000100000000000000000
00000000000000010000000000000000000000000000000000000000000000000000000000100000000000000000
00000000000000010000000000000000000000000000000000000000000000000000000000100000000000000000
00000000000000010000000000000000000000000000000000000000000000000000000000100000000000000000
00000000000000010000000000000000000000000000000000000000000000000000000000100000000000000000
00000000000000010000000000000000000000000000000000000000000000000000000000100000000000000000
00000000000000010000000000000000000000000000000000000000000000000000000000100000000000000000
00000000000000010000000000000000000000000000000000000000000000000000000000100000000000000000
00000000000000010000000111100000000111100000000000111100000000111100000000100000000000000000
00000000000000010000000000000000000000000000000000000000000000000000000000100000000000000000
00000000000000010111111100000000000000000000000000000000000000000011111110100000000000000000
00000000000000010111111100000000000000000000000000000000000000000011111110100000000000000000
00000000000000011111111100000000000111100000000000111100000000000111111110100000000000000000
00000000000000011111111100000000000000000000000000000000000000000111111110100000000000000000
00000000000000011111111100000000000000000000000000000000000000000111111110100000000000000000
00000000000000010111111100000000000000000000000000000000000000000011101110100000000000000000
00000000000000010011111100000000000111100000000000111100000000000001111110100000000000000000
00000000000000010111111110000000000000000000000000000000000000000011111111100000000000000000
00000000000000010111111110000000000000000000000000000000000000000011111111100000000000000000
00000000000000010111111100000000000000000000000000000000000000000011111110100000000000000000
00000000000000010111111100000000000000000000000000000000000000000011111110100000000000000000
00000000000000011111111111111111111111111111111111111111111111111111111111100000000000000000
00000000000000000000000000000000000000000000000000000000000000000000000000000000000000000000
00000000000000000000000000000000000000000000000000000000000000000000000000000000000000000000
00000000000000000000000000000000000000000000000000000000000000000000000000000000000000000000
