-44
47
-21
21
00000000000000000000000000000000000000000000000000000000000000000000000000000000000000000000
00000011111111111111111111111111111111111111111111111111111111111111111111111111111110000000
00000011111111111111111111111111111111111111111111111111111111111111111111111111111110000000
00000011111111111111111111111111111111111111111111111111111111111111111111111111111111111100
00000011111111111111111111111111111111111111111111111111111111111111111111111111111111111100
00000011111111111111111111111111111111111111111111111111111111111111111111111111111111111100
00000111111111110111111100000000000000000000000000000000000000000011111110111111111111111100
00000111111111110111111100000000000000000000000000000000000000000011111110111111111111111100
00000111111111111111111100000000000111100000000001111000000000000111111110111111111111111000
00000111111111111111111100000000000000000000000000000000000000000111111110111111111111111000
00000111111111111111111100000000000000000000000000000000000000000111111110111111111111111000
00000111111111110111111100000000000000000000000000000000000000000011111110111111111111111000
00000111111111110011111100000000000000000000000000000000000000000001111110111111111111111000
00000111111111110111111110000000000111100000000001111000000000000011111111111111111111111000
00000111111111110111111110000000000000000000000000000000000000000011111111111111111111111000
00000111111111110111111100000000000000000000000000000000000000000011111110111111111111111000
00000111111111110111111100000000000000000000000000000000000000000011111110111111111111111000
00000111111111110000000000000000000000000000000000000000000000000000000000111111111111111000
00000011111111110000000111100000000111100000000001111000000000111100000000111111111111111000
00000011111111110000000000000000000000000000000000000000000000000000000000111111111111111000
00000011111111110000000000000000000000000000000000000000000000000000000000111111111111111000
00000011111111110000000000000000000000000000000000000000000000000000000000111111111111111000
00000011111111110000000000000000000000000000000000000000000000000000000000111111111111111000
00000011111111110000000000000000000000000000000000000000000000000000000000111111111111111000
00000011111111110000000000000000000000000000000000000000000000000000000000111111111111111000
00000011111111110000000000000000000000000000000000000000000000000000000000111111111111111000
00000011111111110000000111100000000111100000000000111100000000111100000000111111111111111000
00000011111111110000000000000000000000000000000000000000000000000000000000111111111111111000
00000011111111110111111100000000000000000000000000000000000000000011111110111111111111111000
00000011111111110111111100000000000000000000000000000000000000000011111110111111111111111000
00000011111111111111111100000000000111100000000000111100000000000111111110111111111111111000
00000011111111111111111100000000000000000000000000000000000000000111111110111111111111111000
00000011111111111111111100000000000000000000000000000000000000000111111110111111111111111000
00000011111111110111111100000000000000000000000000000000000000000011101110111111111111111000
00000011111111110011111100000000000111100000000000111100000000000001111110111111111111111000
00000011111111110111111110000000000000000000000000000000000000000011111111111111111111111000
00000011111111110111111110000000000000000000000000000000000000000011111111111111111111111000
00000011111111110111111100000000000000000000000000000000000000000011111110111111111111111000
00000111111111110111111100000000000000000000000000000000000000000011111110111111111111111000
00000111111111111111111111111111111111111111111111111111111111111111111111111111111111110000
00000111111111111111111111111111111111111111111111111111111111111111111111111111111111000000
00000111111111111111111111111111111111111111111111111111111111111111111111111111111111000000
00000011111111111111111111111111111111111111111111111111111111111111111111111111111110000000
