-39
40
-13
15
00000000000000000000000000000000000000000000000000000000000000000000000000000000
00000000000000000000000000000000000000000000000000000000000000000000000000000000
00000000000000000000000000000000000000000000000000000000000000000000000000000000
00000000000000000000000000000000000000000000000000000000000000000000000000000000
00000000000000000000000000000000000000000000000000000000000000000000000000000000
00000000000000001111111111111111111111111111111111111111111111100000000000000000
00000000000000001000000000000000000000000000000000000000000000100000000000000000
00000000000000001000000000000000000000000000000000000000000000100000000000000000
00000000000000001000000000000000001000000010000000000000000000100000000000000000
00000000000000001000000000000000011111110111111100000000000000100000000000000000
00000000000000001000000000000000011111110111111100000000000000100000000000000000
00000000000000001000000000000000011111110111111100000000000000100000000000000000
00000000000000001000000000000000111111110111111110000000000000100000000000000000
00000000000000001000000000000000111111110111111110000000000000100000000000000000
00000000000000001000000000000001111111110111111111000000000000100000000000000000
00000000000000001000000000000000000000000000000000000000000000100000000000000000
00000000000000001000000000000000000000000000000000000000000000100000000000000000
00000000000000001000000000000000000000000000000000000000000000100000000000000000
00000000000000001000000000000000000000000000000000000000000000100000000000000000
00000000000000001000000000000000000000000000000000000000000000100000000000000000
00000000000000001000000000000000000000000000000000000000000000100000000000000000
00000000000000001000000000000000000000000000000000000000000000100000000000000000
00000000000000001000000000000000000000000000000000000000000000100000000000000000
00000000000000001000000000000000000000000000000000000000000000100000000000000000
00000000000000001111111111111111111111111111111111111111111111100000000000000000
00000000000000000000000000000000000000000000000000000000000000000000000000000000
00000000000000000000000000000000000000000000000000000000000000000000000000000000
00000000000000000000000000000000000000000000000000000000000000000000000000000000
00000000000000000000000000000000000000000000000000000000000000000000000000000000
