-21
23
-9
9
000000000000000000000000000000000000000000000
111111111111111111111111111111111111111111110
100000000000000000000000000000000000000000010
100000000000000111111101111111000000000000010
100000000000000111111101111111000000000000010
100000000000000111111101111111000000000000010
100000000000000111111101111111000000000000010
100000000000000111111101111111000000000000010
100000000000000111011101110111000000000000010
100000000000000111011101110111000000000000010
100000000000000000000000000000000000000000010
100000000000000000000000000000000000000000010
100000000000000000000000000000000000000000010
100000000000000000000000000000000000000000010
100000000000000000000000000000000000000000010
100000000000000000000000000000000000000000010
100000000000000000000000000000000000000000010
100000000000000000000000000000000000000000010
111111111111111111111111111111111111111111110
